111111111100000011
100000000100000011
100000000111001110
100000000000000000
104455440001111100
100000000000000000
100000000100444400
111111111100444400
100000811100000000
102333000000000000
102333000000000000
102333001111111111
100000001600077770
111111111000077770
111111111000011111
110000111033011111
110000111033011111
110000111022011111
111001111111111111
111000000777777700
111000000777777700
111111111111111111
