111111111102222222220111111111
100000000102222222210000000001
101111110111111111110111111101
101000010000000000010100001101
101010010001111111010100101101
101000010100000000010100001101
101111110111111111110111111101
100000000102222222210000000001
111111111102222222220111111111
