111111111111111111111111111111111111111
100000009111111111111111111100000011111
100000000111551111111111111100000011111
100000000000000000111111111111001111111
104455440001111100111111109077777708911
100000000000000000111111100077777700011
100000000100444400111111100077777700011
111111111100444400000001111111001111111
180000011100000000000000000111001111111
123333000000000000000000000111001111111
123333000000000000111110000000001111111
123333001111111111111110000000001111111
180000001600077770000000000000001111111
111111111000077770000000000111111111111
111111111000011111111100000111111111111
110990111033011111111100000111192281111
110000111033011111111100000111103301111
110000111022811111111100000000103301111
111001111111111111111100000000000001111
111000000777777777770000000000000001111
111000000777777777770000000011111111111
111111111111111111111111111111111111111
